ncols         10
nrows         15
xllcorner     358275
yllcorner     535275
cellsize      5000
NODATA_value  -9999
-9999 -9999 -9999 1 -9999 -9999 -9999 -9999 -9999 -9999
-9999 -9999 -9999 -9999 -9999 -9999 -9999 -9999 -9999 -9999
-9999 1 -9999 -9999 -9999 -9999 -9999 -9999 -9999 1
-9999 1 1 -9999 -9999 -9999 -9999 -9999 -9999 -9999
-9999 -9999 1 -9999 -9999 -9999 -9999 1 -9999 -9999
-9999 -9999 -9999 -9999 -9999 -9999 -9999 1 -9999 -9999
-9999 -9999 -9999 -9999 -9999 -9999 -9999 1 1 -9999
-9999 -9999 -9999 -9999 1 -9999 -9999 -9999 -9999 -9999
-9999 -9999 -9999 -9999 -9999 -9999 -9999 -9999 -9999 -9999
-9999 -9999 -9999 -9999 -9999 -9999 -9999 -9999 -9999 -9999
-9999 -9999 -9999 -9999 -9999 -9999 -9999 -9999 1 1
-9999 -9999 -9999 -9999 -9999 -9999 -9999 -9999 1 1
-9999 -9999 -9999 -9999 -9999 -9999 -9999 -9999 -9999 1
-9999 -9999 -9999 -9999 -9999 1 -9999 -9999 -9999 -9999
-9999 -9999 -9999 -9999 -9999 -9999 -9999 -9999 -9999 -9999
